0000000000000000000000000000000000000000000000000000000000000000000000000000
0000000000000000000000000000000000000000000000000000000000000000000000000000
0000000000000000000000000000000000000000000000000000000000000000000000000000
0000000000000000000000000000000000000000000000000000000000000000000000000000
0000000000000000000000000000000000000000000000000000000000000000000000000000
0000000000000000000000000000000000000000000000000000000000000000000000000000
0000000000000000000000000000000000000000000000000000000000000000000000000000
0000000000000000000000000000000000000000000000000000000000000000000000000000
0000000000000000000000000000000000000000000000000000000000000000000000000000
0000000000000000000000000000000000000000000000000000000000000000000000000000
0000000000000000000000000000000000000000000000000000000000000000000000000000
0000000000000000000000000000000000000000000000000000000000000000000000000000
0000000000000000000000000000000000000000000000000000000000000000000000000000
0000000000000000000000000000000000000000000000000000000000000000000000000000
0000000000000000000000000000100000000000000000000000000000000000000000000000
0000000000000000000000000000100000000000000000000000000000000000000000000000
0000001110000000000000000000100000000000000000000000000000000000000000000000
0000010001000000000000000000100000000000000000000000000000000000000000000000
0000001110000000000000000000100000000000000000000000000000000000000000000000
0000000000000000000000000000100000000000000000000000000000000000000000000000
0000000000000000000000000000100000000000000000000000000000000000000000000000
0000000000000000000000000000100000000000000000000000000000000000000000000000
0000000000000000000000000000100000111111111111111111000000000000000000000000
0000000000000000000000000000100000000000000000000000000000000000000000000000
0000000000000000000000000001110000000000000000000000000000000000000000000000
0000000000000000000000000011111000000000000000000000000001100000000000000000
0000000000000000000000000111111100000000000000000000000011100000000001110000
0000000000000000000000001111111110000000000000000011111111111100000000000000
0011100000000000000000011111111111000000000000000011111111111100000000000000
1111111111111111111111111111111111111111111111111111111111111111111111111111
