0000000000000000000000
0000000000000000000000
1110000000000000000111
1100000000000000000011
1000000000000000000001
0000000000000000000000
0000000000000000000000
0000000000000000000000
0000000000000000000000
0000000000000000000000
0000000000000000000000
0000000000000000000000
0000000000000000000000
0000000000000000000000
1000000000000000000001
1100000000000000000011
1110000000000000000111
