0000000000000000000000
0000000000000000000000
1100000000000000000011
1000000000200000000001
0000000000000000000000
0000000000000000000000
0000000000000000000000
0000000001111000000000
0000000001111000000000
0000000001111000000000
0000000001111000000000
0000000000000000000000
0000000000000000000000
0000000000000000000000
0000000000200000000000
1000000000000000000001
1100000000000000000011
